###################################################################
#.....#############################################################
#.....##########.....#####################....#####.....###########
#........#######........##################....#####.....###########
#.....##.#######.....##.##################....#####.....###########
#.....##.#######.....##.##################....#####.....###########
###.####.#########.####.###################.#########.#############
###.####.#########.####.###################.#########.#############
###.####.##.....##.####.###################.#########.#############
###.####.##........####.###################.#########.#############
###.####.##.....##.####.###################.#########.#############
###.####.##.....##.####.###################.#########.#############
###.####.####.####.####.###################.#########.#############
###.####.####.##.....##.############.....#....######.........######
###.####.####.##.....#....##########..........#....#.........######
###.####.####.##.....#.......#######...............#.........######
###.####.####.##.....#....##.#######..........#....#.........######
###.####.####.##.....#....##.#######..........#....#.........######
###.####.####.#########.####.#########.####.####.####.####.########
###.####.####.#########.####.#########.##..........##.####.########
###.####.##.....#######.####.#######...............##.####.########
###.####.##.....#######.####.#######..................####.########
###.####.##.....#######.####.#######...............#######.########
###.####.##.....#######.####.#######...............#######.########
###.####.####.#########.####.#########.#########.#########.########
###.##.....##.#########.##.....#######.#########.#########.########
###.##.....##.#########.##.....######....#####.....#####.....######
###.##........#########.##...............#####.....#####.....######
###.##.....############.##.....######....#####.....#####.....######
###.##.....############.##.....######....#####.....#####.....######
###.###################.####.#############################.########
###.#################.....#....###########################.########
#.....###############.....#....##########################....######
#.....###############.....#....##########################....######
#.....###############.....#....##########################....######
#.....###############.....#....##########################....######
###################################################################
###################################################################
