###################################################################
###################################################################
######.....#####.....###############.....##########################
######.....#####.....###############.....##########################
######.....#####.....###############.....##########################
######.....#####.....###############.....##########################
########.#########.###################.############################
######.....#######.##.....############.###....#####################
######.....#####..........############.###....#####################
######........##.............#########.###....#####################
######.....##.##..........##.#########.###....#####################
######.....##.##..........##.#########.###....#####################
########.####.####.####.####.#########.####.#######################
##....##.##.....##.####.####.#########.####.###....################
##....##.##.....##.####.##.....#######.####.###....#....###########
##.......##........####.##.........................#....###########
##....##.##.....##.####.##.....##.####.####.###....#....###########
##....##.##.....##.####.##.....##.####.####.###....#....###########
########.#########.####.#########.####.####.####.####.#############
########.#########.####.#########.####.###....##.####.#############
########.#########.####.########....#.........##.####.#############
########.#########.####.########.................####.#############
########.#########.####.########....#.........##.####.#############
########.#########.####.########....#.........##.####.#############
########.#########.####.##############.####.####.####.#############
########.#########.####.############.....##.##.....##.#############
########.#########.###....##########.....##.##.....##.#############
########.#########.###....##########........##........#############
########.#########.###....##########.....#####.....################
########.#########.###....##########.....#####.....################
########.#########.####.###########################################
#######....######....##.###########################################
######.....######....#....#########################################
######....................#########################################
######.....######....#....#########################################
######.....######....#....#########################################
###################################################################
###################################################################
