###################################################################
######.....######################..################################
###..#.....#####...###....######....###############.........#######
##............#....###.................############..........######
##.........##.#....###....#.....##...#.############..........######
##.........##.#...####....#....####..#.#############.........######
##........###.#...####...#.....####....##############........######
##.........##.....####.........####....##..###.....###........#####
##................#####........#####........##.....###............#
##...##............####.........#####.......##...............#....#
########............###.#.......#####......###.....##.###....#....#
###########.........###.#.......#####......###.....##.####........#
#####...####.........##........######......#####....#.####......###
####....####...##..............######.......####........##......###
###.....#####.####............########.......##.........##.#....###
###.....#####.####............########.##...............##.#....###
##......#####.####........#...########.###..............##.#....###
##......#####.###........###....######.###...............#.#..#.###
###....######.##........####......####.##................#.#..#.###
#############.#.........####........##.#......................#.###
###########.............#####.......##.#........................###
###########.............#####.......##.##.......................###
####....###.....#############....#####.###......................###
###......##.....############......####.###.......####............##
##........#################........###.###...###.####....#.###...##
##.........############............##.......####.###....##.####.###
###.........#########.........##..###....#.#####.###....##.####.###
####........#######...........#######............###.......####.###
####.........#####............#######....###########....##.####.###
####...........................######....###########....##.####.###
####............................#####....#################.####.###
####............................#####....###############.....##.###
#####..........................######....###############.....##.###
#####.........................######.....###############........###
####...........##.......############....################.....######
####..........####.....##############..#################.....######
#####.#############################################################
###################################################################
