PPPPPPPPPPPPPPPPPPPPPPPPPPPPPPPPPPPPPPPPPPPPPPPPPPPPPPPPPPPPPPPPPPP
PPPPPPHHHHHPPPPPHHHHHPPPPPPPPPPPPPPPHHHHHPPPPPPPPPPPPPPPPPPPPPPPPPP
PPPPPL.....NPPPL.....NPPPPPPPPPPPPPL.....NPPPPPPPPPPPPPPPPPPPPPPPPP
PPPPPL.....NPPPL.....NPPPPPPPPPPPPPL.....NPPPPPPPPPPPPPPPPPPPPPPPPP
PPPPPL.....NPPPL.....NPPPPPPPPPPPPPL.....NPPPPPPPPPPPPPPPPPPPPPPPPP
PPPPPL.....NPPPL.....NPPPPPPPPPPPPPL.....NPPPPPPPPPPPPPPPPPPPPPPPPP
PPPPPPGC.EGPPPPPOK.MOHHHHHPPPPPPPPPPOK.MOPHHHHPPPPPPPPPPPPPPPPPPPPP
PPPPPL.....NPPPPHD.FD.....NPPPPPPPPPPL.NPL....NPPPPPPPPPPPPPPPPPPPP
PPPPPL.....FHHPL..........FHHPPPPPPPPL.NPL....NPPPPPPPPPPPPPPPPPPPP
PPPPPL........NL.............NPPPPPPPL.NPL....NPPPPPPPPPPPPPPPPPPPP
PPPPPL.....MK.NL..........MK.NPPPPPPPL.NPL....NPPPPPPPPPPPPPPPPPPPP
PPPPPL.....NL.NL..........NL.NPPPPPPPL.NPL....NPPPPPPPPPPPPPPPPPPPP
PPHHHHOK.MOHD.FHOK.MOOK.MOPL.NPPPPPPPL.NPPK.MOPHHHHPPPPPPPPPPPPPPPP
PL....NL.NL.....NL.NPPL.NPHD.FHPPPPPPL.NPPL.NPL....NHHHHPPPPPPPPPPP
PL....FD.NL.....FD.NPPL.NL.....FHHHHHD.FHHD.FHD....J....NPPPPPPPPPP
PL.......NL........NPPL.NL.........................J....NPPPPPPPPPP
PL....MK.NL.....MK.NPPL.NL.....MK.MOOK.MOOK.MOK....J....NPPPPPPPPPP
PL....NL.NL.....NL.NPPL.NL.....NL.NPPL.NPPL.NPL....J....NPPPPPPPPPP
PPOOOOPL.NPOOOOOPL.NPPL.NPOOOOOPL.NPPL.NPPD.FHPK.MOPK.MOPPPPPPPPPPP
PPPPPPPL.NPPPPPPPL.NPPL.NPPPPPPPD.FHPD.FHD....NL.NPPL.NPPPPPPPPPPPP
PPPPPPPL.NPPPPPPPL.NPPL.NPPPPPPL....B.........FD.NPPL.NPPPPPPPPPPPP
PPPPPPPL.NPPPPPPPL.NPPL.NPPPPPPL.................NPPL.NPPPPPPPPPPPP
PPPPPPPL.NPPPPPPPL.NPPL.NPPPPPPL....I.........MK.NPPL.NPPPPPPPPPPPP
PPPPPPPL.NPPPPPPPL.NPPL.NPPPPPPL....J.........NL.NPPL.NPPPPPPPPPPPP
PPPPPPPL.NPPPPPPPL.NPPL.NPPPPPPPOOOOHC.EGOK.MOHD.FHPL.NPPPPPPPPPPPP
PPPPPPPL.NPPPPPPPL.NPPD.FHPPPPPPPPPL.....NL.NL.....NL.NPPPPPPPPPPPP
PPPPPPPL.NPPPPPPPL.NPL....NPPPPPPPPL.....FD.NL.....FD.NPPPPPPPPPPPP
PPPPPPPL.NPPPPPPPL.NPL....NPPPPPPPPL........NL........NPPPPPPPPPPPP
PPPPPPPL.NPPPPPPPL.NPL....NPPPPPPPPL.....MOOPL.....MOOPPPPPPPPPPPPP
PPPPPPPL.NPPPPPPPL.NPL....NPPPPPPPPL.....NPPPL.....NPPPPPPPPPPPPPPP
PPPPPPPD.FHPPPPPPD.FHPK.MOPPPPPPPPPPOOOOOPPPPPOOOOOPPPPPPPPPPPPPPPP
PPPPPPD....NPPPPL....ND.FHPPPPPPPPPPPPPPPPPPPPPPPPPPPPPPPPPPPPPPPPP
PPPPPL.....FHHHHD....B....NPPPPPPPPPPPPPPPPPPPPPPPPPPPPPPPPPPPPPPPP
PPPPPL....................NPPPPPPPPPPPPPPPPPPPPPPPPPPPPPPPPPPPPPPPP
PPPPPL.....MOOOOK....I....NPPPPPPPPPPPPPPPPPPPPPPPPPPPPPPPPPPPPPPPP
PPPPPL.....NPPPPL....J....NPPPPPPPPPPPPPPPPPPPPPPPPPPPPPPPPPPPPPPPP
PPPPPPOOOOOPPPPPPOOOOPOOOOPPPPPPPPPPPPPPPPPPPPPPPPPPPPPPPPPPPPPPPPP
PPPPPPPPPPPPPPPPPPPPPPPPPPPPPPPPPPPPPPPPPPPPPPPPPPPPPPPPPPPPPPPPPPP
